5	6	0	5	6	0	5	6	0	5	6	0	5	6	0	5	6	0	5	6	0	5	6	0	5	6	0	5	6	0	5	6	0	5	6	0	5	6	0	5	6	0	5	6	0	5	6	0	5	6	0	5	6	0	5	6	0	5	6	0	5	6	0	5	6	0	5	6	0	5	6	0	5	6	0	5	6	0
5	6	1	5	6	1	5	6	1	5	6	1	5	6	1	5	6	1	5	6	1	5	6	1	5	6	1	5	6	1	5	6	1	5	6	1	5	6	1	5	6	1	5	6	1	5	6	1	5	6	1	5	6	1	5	6	1	5	6	1	5	6	1	5	6	1	5	6	1	5	6	1	5	6	1	5	6	1
5	11	1	5	12	1	5	12	1	5	12	1	5	12	1	5	12	1	5	12	1	5	12	1	5	12	1	5	12	1	5	12	1	5	12	1	5	12	1	5	12	1	5	12	1	5	12	1	5	12	1	5	12	1	5	12	1	5	12	1	5	12	1	5	12	1	5	12	1	5	12	1	5	12	1	5	12	1
5	11	1	5	12	1	5	12	1	5	12	1	5	12	1	5	12	1	5	12	1	5	12	1	5	12	1	5	12	1	5	12	1	5	12	1	5	12	1	5	12	1	5	12	1	5	12	1	5	12	1	5	12	1	5	12	1	5	12	1	5	12	1	5	12	1	5	12	1	5	12	1	5	12	1	5	12	1
5	11	1	5	12	1	5	12	1	5	12	1	5	12	1	5	12	1	5	12	1	5	12	1	5	12	1	5	12	1	5	12	1	5	12	1	5	12	1	5	12	1	5	12	1	5	12	1	5	12	1	5	12	1	5	12	1	5	12	1	5	12	1	5	12	1	5	12	1	5	12	1	5	12	1	5	12	1
5	12	1	5	12	1	5	12	1	5	12	1	5	12	1	5	12	1	5	12	1	5	12	1	5	12	1	5	12	1	5	12	1	5	12	1	5	12	1	5	12	1	5	12	1	5	12	1	5	12	1	5	12	1	5	12	1	5	12	1	5	12	1	5	12	1	5	12	1	5	12	1	5	12	1	5	12	1
5	12	1	5	12	1	5	12	1	5	12	1	5	12	1	5	15	0	5	16	0	5	12	1	5	18	0	5	12	1	5	20	0	5	12	1	5	22	0	5	14	0	5	15	0	5	16	0	5	12	1	5	18	0	5	12	1	5	20	0	5	12	1	5	12	1	5	12	1	5	12	1	5	12	1	5	12	1
5	12	1	5	11	1	5	12	1	5	13	1	5	14	1	5	15	1	5	16	1	5	17	1	5	18	1	5	19	1	5	20	1	5	21	1	5	22	1	5	14	1	5	15	1	5	16	1	5	17	1	5	18	1	5	19	1	5	20	1	5	21	1	5	22	1	5	12	1	5	12	1	5	12	1	5	12	1
5	12	1	5	11	2	5	12	2	5	13	2	5	14	2	5	15	2	5	16	2	5	17	2	5	18	2	5	19	2	5	20	2	5	21	2	5	22	2	5	14	2	5	15	2	5	16	2	5	17	2	5	18	2	5	19	2	5	20	2	5	21	2	5	22	2	5	12	1	5	12	1	5	12	1	5	12	1
5	12	1	5	11	3	5	12	3	5	13	3	5	14	3	5	15	3	5	16	3	5	17	3	5	18	3	5	19	3	5	20	3	5	21	3	5	22	3	5	14	3	5	15	3	5	16	3	5	17	3	5	18	3	5	19	3	5	20	3	5	21	3	5	22	3	5	12	1	5	12	1	5	12	1	5	12	1
5	12	1	5	11	4	5	12	4	5	13	4	5	14	4	5	15	4	5	16	4	5	17	4	5	18	4	5	19	4	5	20	4	5	21	4	5	22	4	5	14	4	5	15	4	5	16	4	5	17	4	5	18	4	5	19	4	5	20	4	5	21	4	5	22	4	5	12	1	5	12	1	5	12	1	5	12	1
5	12	1	5	11	5	5	12	5	5	13	5	5	14	5	5	15	5	5	16	5	5	17	5	5	18	5	5	19	5	5	20	5	5	21	5	5	22	5	5	14	5	5	15	5	5	16	5	5	17	5	5	18	5	5	19	5	5	20	5	5	21	5	5	22	5	5	12	1	5	12	1	5	12	1	5	12	1
5	12	1	5	11	6	5	12	6	5	13	6	5	14	6	5	15	6	5	16	6	5	17	6	5	18	6	5	19	6	5	20	6	5	21	6	5	22	6	5	14	6	5	15	6	5	16	6	5	17	6	5	18	6	5	19	6	5	20	6	5	21	6	5	22	6	5	12	1	5	12	1	5	12	1	5	12	1
5	12	1	5	11	7	5	12	7	5	13	7	5	14	7	5	15	7	5	16	7	5	12	1	5	18	7	5	19	7	5	20	7	5	12	1	5	22	7	5	14	7	5	15	7	5	16	7	5	12	1	5	18	7	5	12	1	5	20	7	5	12	1	5	22	7	5	12	1	5	12	1	5	12	1	5	12	1
5	12	1	5	12	1	5	12	1	5	12	1	5	12	1	5	12	1	5	12	1	5	12	1	5	12	1	5	12	1	5	12	1	5	12	1	5	12	1	5	12	1	5	12	1	5	12	1	5	12	1	5	12	1	5	12	1	5	12	1	5	12	1	5	12	1	5	12	1	5	12	1	5	12	1	5	12	1
