5	0	2	5	1	3	5	1	3	5	1	3	5	1	3	5	1	3	5	1	3	5	1	3	5	1	3	5	1	3	5	1	3	5	1	3	5	1	3	5	1	3	5	1	3	5	1	3	5	1	3	5	1	3	5	1	3	5	1	2
5	0	3	5	1	3	5	1	3	5	1	3	5	1	3	5	1	3	5	1	3	5	1	3	5	1	3	5	1	3	5	1	3	5	1	3	5	1	3	5	1	3	5	1	3	5	1	3	5	1	3	5	1	3	5	1	3	5	1	3
5	0	4	5	1	4	5	1	4	5	1	4	5	1	4	5	1	4	5	1	4	5	1	4	5	1	4	5	1	4	5	1	4	5	1	4	5	1	4	5	1	4	5	1	4	5	1	4	5	1	4	5	1	4	5	1	4	5	1	4
5	3	0	5	3	0	5	3	0	5	3	0	5	3	0	5	3	0	5	3	0	5	3	0	5	3	0	5	3	0	5	3	0	5	3	0	5	3	0	5	3	0	5	3	0	5	3	0	5	3	0	5	3	0	5	3	0	5	3	0
5	3	0	5	3	0	5	3	0	5	3	0	5	3	0	5	3	0	5	3	0	5	3	0	5	3	0	5	3	0	5	3	0	5	3	0	5	3	0	5	3	0	5	3	0	5	3	0	5	3	0	5	3	0	5	3	0	5	3	0
5	3	0	5	3	0	5	3	0	5	3	0	5	3	0	5	3	0	5	3	0	5	3	0	5	3	0	5	3	0	5	3	0	5	3	0	5	3	0	5	3	0	5	3	0	5	3	0	5	3	0	5	3	0	5	3	0	5	3	0
5	3	0	5	3	0	5	3	0	5	3	0	5	3	0	5	3	0	5	3	0	5	3	0	5	3	0	5	3	0	5	3	0	5	3	0	5	3	0	5	3	0	5	3	0	5	3	0	5	3	0	5	3	0	5	3	0	5	3	0
5	3	0	5	3	0	5	3	0	5	3	0	5	3	0	5	3	0	5	3	0	5	3	0	5	3	0	5	3	0	5	3	0	5	3	0	5	3	0	5	3	0	5	3	0	5	3	0	5	3	0	5	3	0	5	3	0	5	3	0
5	3	0	5	3	0	5	3	0	5	3	0	5	3	0	5	3	0	5	3	0	5	3	0	5	3	0	5	3	0	5	3	0	5	3	0	5	3	0	5	3	0	5	3	0	5	3	0	5	3	0	5	3	0	5	3	0	5	3	0
5	3	0	5	3	0	5	3	0	5	3	0	5	3	0	5	3	0	5	3	0	5	3	0	5	3	0	5	3	0	5	3	0	5	3	0	5	3	0	5	3	0	5	3	0	5	3	0	5	3	0	5	3	0	5	3	0	5	3	0
5	3	0	5	3	0	5	3	0	5	3	0	5	3	0	5	3	0	5	3	0	5	3	0	5	3	0	5	3	0	5	3	0	5	3	0	5	3	0	5	3	0	5	3	0	5	3	0	5	3	0	5	3	0	5	3	0	5	3	0
5	3	0	5	3	0	5	3	0	5	3	0	5	3	0	5	3	0	5	3	0	5	3	0	5	3	0	5	3	0	5	3	0	5	3	0	5	3	0	5	3	0	5	3	0	5	3	0	5	3	0	5	3	0	5	3	0	5	3	0
5	3	0	5	3	0	5	3	0	5	3	0	5	3	0	5	3	0	5	3	0	5	3	0	5	3	0	5	3	0	5	3	0	5	3	0	5	3	0	5	3	0	5	3	0	5	3	0	5	3	0	5	3	0	5	3	0	5	3	0
5	3	0	5	3	0	5	3	0	5	3	0	5	3	0	5	3	0	5	3	0	5	3	0	5	3	0	5	3	0	5	3	0	5	3	0	5	3	0	5	3	0	5	3	0	5	3	0	5	3	0	5	3	0	5	3	0	5	3	0
5	3	0	5	3	0	5	3	0	5	3	0	5	3	0	5	3	0	5	3	0	5	3	0	5	3	0	5	3	0	5	3	0	5	3	0	5	3	0	5	3	0	5	3	0	5	3	0	5	3	0	5	3	0	5	3	0	5	3	0
